BABY	B EY B IY
BACK	B AE K
BEAUTIFUL	B Y UW T AH F AH L
CIRRUS	S IH R AH S
DOWN	D AW N
ENERGY	EH N ER JH IY
FORWARD	F AO R W ER D
FULL	F UH L
HALF	HH AE F
HALT	HH AO L T
LEFT	L EH F T
NEVER	N EH V ER
PAUSE	P AO Z
PLAY	P L EY
RECURRING	R IH K ER IH NG
RECURRING(2)	R IY K ER IH NG
RIGHT	R AY T
SILVER	S IH L V ER
SPEED	S P IY D
STOP	S T AA P
UNPAUSE	AH N P AO Z
UP	AH P
VOLUME	V AA L Y UW M
